11111111111111111111
10010C00011111000001
1000100C00111C00C001
10CC0C0P001100000001
10CEC00C001100010001
100C0100C00000010001
10C0010000C000010001
11111111111111111111
11111111111111111111
11111111111111111111
11111111111111111111
11111111111111111111