11111111
11100111
110C0001
1P001111
1E1010C1
11111111