1111111111111111
10C000C000010001
1P0C1000C1101001
10C0011000000001
1C00110CE0000001
1111111110000C01
1111111110000001
1111111110000001
111111111000C001
111C000000000001
11111111100C0001
1111111111111111